1111111111111111111111111111
1............1.............1
1.11111.1111.1.1111.111111.1
1.1   1.1  1.1.1  1.1    1.1
1.11111.1111.1.1111.111111.1
1..........................1
1.11111.11.11111.11.111111.1
1.......11...1...11........1
1111111.1111.1.1111.11111111
      1.11...G...11.1       
1111111.11.11111.11.11111111
T      .11.1   1.11.       T
1111111.11.11111.11.11111111
      1.11.1   1.11.1       
1111111.11.11111.11.11111111
1..........................1
1.11111.11..111..11.111111.1
1....11....1   1....11.....1
1111.11.11111111111.11.11111
11...11.............11....11
1111.1111111.111111111.11111
1...........P..............1
1111111111111111111111111111