111111111111111111111111111111111111
1.1111111.11111111111.111111.1111 .1
1.....................111.....1111.1
1.1111111.1111111.....111111.......1
1.....................111111.11111.1
1...1111111111111..................1
1..................................1
1.......111111111....111111111.....1
1.........................1111.....1
1..........................111.....1
1............P......111111111......1
1..11111111111.....................1
1..................................1
1..................................1
1..................................1
1..................................1
111111111111111111111111111111111111
