111111111111111111111111111
1G...........1............1
1............1............1
1............1............1
1............1...........P1
1............1............1
1............1............1
1............1............1
1.........................1
1............1............1
1............1............1
111111111111111111111111111