111111111111111111111111111111
1000P0000000001100000000000001
101111011111101101111110111101
100000010000101101000010000001
101111010000101101000010111101
100000011111101101111110000001
101100000000001100000000001101
100101011111101101111110101001
100101000000000000000000101001
101101010111111111111010101101
100101010000010010000010101001
100101010011010010110010101001
101101011111011110111110101101
100001000000000000000000100001
111101111100111111000111101111
000000000000100010000000000000
111101000000111111000000101111
100001011111000000111110100001
101101010011011110110010101101
101101010000010010000010101101
101101010111111111111010101101
100001000000000000000000100001
101101011111101101111110101101
101100000000001100000000001101
100000011111101101111110000001
101111010000101101000010111101
100000010000101101000010000001
101111011111101101111110111101
100000000000001100000000000001
111111111111111111111111111111