C11111111111111111111111111111111V
F3           F                  3F
F C111V C11V F C11V C1111V C111V F
F FOOOF FOOF F FOOF FOOOOF F     F
F N111B N11B F N11B N1111B N111B F
F                                F
F J1111M V J1111M V J1111111111M F
F        F   F    F              F
N111111V F1M F J11V C111111111111B
OOOOOOOF F G      F FOOOOOOOOOOOOO
1111111B F C1DD1V F N1111111111111
         F Fpic F F               
1111111V F F    F F C1111111111111
OOOOOOOF F F   HF F FOOOOOOOOOOOOO
C111111B F J1111M F N111111111111V
F                                F
F J111V J1 C111V JM C1111111111M F
F     F        FOOOF    F        F
F111M F 111111111111111 F J111111F
F     F             F            F
F11M J11111M J1111111111111M J111F
F3         P.                   3F
N11111111111111111111111111111111B